11223344111231423143
26
26
00000000000000000000000000
00000000000000000000000000
00000000000000000000000000
00000000000001100000000000
00000000000000110000000000
00000000000000010000000000
00000000000000010000010000
00000000110000011000110000
00000001001000001000100000
00000001000110001001100000
00000010000001001001000000
00000010000001011011000000
00000011000000010010000000
00000001000000110100000000
00000000100000111000000000
00000000011101111000000000
00000000000111000100000000
00000000001100000000000000
00000001110000000100000000
00001110000000000011000000
00110000000000000001000000
00100000000000000001100000
00011110000000000000100000
00000000111011011111110000
00000000000000000000000000
00000000000000000000000000
