11223344111231423143
26
26
00000000000000000000000000
00000000000000000000000000
00000000000000000000000000
00000000000000000000000000
00000000000000000000000000
00000000000000000000000000
00000000000000000000000000
00000003333333333000000000
00000003000000003300000000
00000003330000000300000000
00000000033330000300000000
00000000000033333000000000
00000000000000033333000000
00000000000000330000000000
00000000000003300000000033
00000000000033000000003333
00000000000030000000333003
00000000000330000033300003
00000000003300003330000033
00000000003000333000000330
00000000033033300000003300
00000000033330000000003000
00000000000000000000030000
00000000000000000000000000
00000000000000000000000000
00000000000000000000000000
