11223344111231423143
26
26
00000000000000000000000000
00000000000000000000000000
00000000000000000000000000
00000000000000000000000000
00000000000011100000000000
00000000000000110000000000
00000000000000010000100000
00000000000000111001000000
00000100000000101001000000
00000100000001000110000000
00000100001110000010000000
00000111111000000101000000
00000000000000001000100000
00000000000000001000010000
00000000000000010000011000
00000000000000110000000000
00000000000001000000000000
00000000000110000000000000
00000000111000000000000000
00000111000000000000000000
00000000000000000000000000
00000000000000000000000000
00000000000000000000000000
00000000000000000000000000
00000000000000000000000000
00000000000000000000000000
