11223344111231423143
26
26
00000000000000000000000000
00000000000000000000000000
00220022000000000022002200
00220022330033003322002200
00220022330033003322002200
00220022000000000022002200
00220022002200220022002200
00220022002222220022002200
00220055552222225555002200
00000055552200225555000000
00000000002200220000000000
22000000002200220000000022
11000000000000000000000011
55333333000000000033333355
00333333000000000033333300
00000000000000000000000000
00000000002200220000000000
00220022002200220022002200
00220022002200220022002200
00220022002200220022002200
00220022002200220022002200
00220022000000000022002200
00220022000000000022002200
00220022000222200022002200
00000000000200200000000000
00000000000200200000000000
