11223344111231423143
26
26
00000000000000000000000000
00000000000000000000000000
00000000000000000000000000
00000000000000000000000000
00000000000000000000000000
00000002222200022200000000
00000020000020020022000000
00000220000002200220200000
00000200000000202200200000
00000200000000220000020000
00000200000002202000020000
00000222000022002000002000
00000002222202000200002000
00000000000020000200002000
00000000000000000020002000
00000000000020000002002000
00000000000200000002002000
00000000000200000000202000
00002220000000000000222000
00002002220200000000022000
00002000002222220000000000
00000200002000002220000000
00000022020000000000000000
00000002200000000000000000
00000000000000000000000000
00000000000000000000000000
