11223344111231423143
26
26
00000000000000000000000000
00000000000000000000000000
00000000000000000000000000
00055555000000000000000000
00050000550000000000000000
00500000055000000000000000
00500000000500000000000000
00500000000500000000000000
00050000000050000000000000
00055000000050000000000000
00005500000050000000000000
00000055000005000000000000
00000000555555555555500000
00000000000005000000000000
00000000000005000000005000
00000005500005000000005000
00000550055050000000005000
00000500000555000000050000
00000500000050550000050000
00000050000550005500050000
00000055000500000055500000
00000005505500000005500000
00000000555000000000000000
00000000000000000000000000
00000000000000000000000000
00000000000000000000000000
